1111111111111
10010000000C1
1100011110011
1P0011E000001
1111111111111