1111111111111
10010000000C1
1100011111E01
1P00110000001
1111111111111